11111111
10E01011
1C0E0P11
11111111
