1111111111111
1110000C00111
1100011110P11
110011E000001
1111111111111