11111111
10E01011
10000P11
11111111
