111111
1111E1
1111C1
1P1111
111111
