11111111
10E01P11
1C000P11
11111111
