11111
1P001
1E001
10C01
11111
