11111111111
11PCE111111
11111111111
11111111110
